PMT.#TM#T###
T#..TTP.P...
M#...#.T.T.#
T#P#.....P#.
PM.##.PPM#T.
#P.#T.MTM.TP
#.#M.P.T.MM#
T#...PT.....
.MM#M.#..#..
##T#.TT.T...
#PM.P..#.PT#
AS..M#E.#MM#